11111111111111111111
1P0000000000000000C1
11111111111111111101
10000000000000000001
10111111111111111111
10000000000000000001
11111111111111111101
1C0000000000000000E1
11111111111111111111