111111111
100000001
10X010111
1100P0C11
1010000E1
111111111