1111111111
1P000000C1
1000000001
1P0000E00
111111111