11111111
1C000001
10111011
1000C001
11101E01
1P000001
11111111