1111111111111111111
1P0C000000000000001
1111101110111110101
100000100010000C001
1011101011101110101
1C00000010000000101
1011111110111110101
10000000000C00000E1
1111111111111111111